1111111111111111111111111111111111
1E0000000000000C00000C000000000001
101001010B10000010100100B000010101
1B10B10010101010001001000B00010101
1P0000000C00C000B000000000B00000C1
1111111111111111111111111111111111